후 리스 -> 후리스
Y 존 -> Y존
에어 프라이어 -> 에어프라이어
개인 용 -> 개인용
차량 용 -> 차량용
방 탈출 -> 방탈출
풍 성하다 -> 풍성하다
배양 액 -> 배양액
샤워 기 -> 샤워기
집 순이 -> 집순이
프라이 빗 -> 프라이빗 
스타 일링 -> 스타일링
스타 일리 쉬다 -> 스타일리쉬
스타 일리 -> 스타일리쉬
플레이 팅 -> 플레이팅
고양 -> 고양이 (경기도 고양 x, 슈뢰딩거 고양이 관련 프로젝트)
디 스펜서 -> 디스펜서
아가 일 -> 아가일
스포츠 웨어 -> 스포츠웨어
갓 성비 -> 가성비
페스 토 -> 페스토
레터 링 -> 레터링
닭 가슴 살 -> 닭가슴살
플레이 트 -> 플레이트
로맨스 판타지 -> 로맨스판타지
기능 성 -> 기능성
파트너 스 -> 파트너스
calendar -> 캘린더
자연 친 화 -> 자연친화
끝 판 왕 -> 끝판왕
리버 블 -> 리버시블 ('리버 시 블' 에서 ' 시 '가 지워져서 '리버 블'만 남은게 있었나봄)
에코 백 -> 에코백
구 독자 -> 구독자
인공 지능 -> 인공지능
리미 티드 -> 리미티드 (합치긴 했는데 삭제해도 될듯)
프로 바이 틱 스 -> 프로바이틱스 (프로바이오틱스인줄 알았는데 찾아보니 프로바이틱스였음)
귀 찌 -> 귀찌
귀 여 움 -> 귀여움
프로 페셔널 -> 프로페셔널
